####P###########P####
####.###########.####
####.#####D#####.####
#...................#
####.............####
####.##.##.##.##.####
####.##.##.##.##.####
##D.....##.##.....D##
####.##.##.##.##.####
####.##.##.##.##.####
####.............####
#...................#
####D#####.#####D####
####.#####.#####.####
##########P##########
